1111111111
1P01000001
1001001001
1011001111
101C0010E1
1010001111
1011100001
1000110111
1C100000C1
1111111111