1111111111111
1P00000000001
1010010111101
1010010000101
1011110111101
1000C101E0001
1000010111101
1000000000001
1111111111111