1111111111
1P01100011
1011001001
1011001101
10100011C1
101E001111
1011100001
1000111011
1C100000C1
1111111111