1111111111
1P01000001
1001001001
1011001001
10100010E1
101C001111
1011100001
1000111001
1C10000001
1111111111