1111111111
1001000001
1001001001
1011001001
10100010E1
101C001111
1011100001
1000110011
1C100000C1
1111111111