1111111111
1P01000001
1001001001
1011001001
10100010E1
1010001111
1011100001
1000110011
1010000001
1111111111