1111111111
1P01000001
1001001001
1011001001
10100010E1
101C001111
10111000E1
1000110011
1C100000C1
1111111111