1111111111111
1P00000000001
1010010111101
1010010000101
101111C111101
1000010100001
1000010111101
10000000000E1
1111111111111